
80000000000F45F00000000009
81111111111111111111111119
81111111111111111111111119
8111I111111111111111111119
81111111t11111111t11111119
81111111111111111111111119
811111111111111c1111111119
81111111111111111111111119
81111111111111111111111119
811111111111k1111111111119
81111111111111111111111119
81111111111111111111111119
8111111111c111111111111119
81111111111111111111111119
81111111t11111111t111I1119
81111111111111111111111119
eoof111111111111111111gooa
   eof00000045000000goa
     8111111111111119
     81&111111111c119
     8111111111111119
     811111111111c119
     8111111111111119
     811111111111c119
     8111111111111119
     8111111111111119
80000070000045000000000009
8111116k1111111111111111k9
811111611s111111s111111119
81&&&161111111111111111119
81111161111111111111I11119        6
811111p001111111s111111119        6
800400qc111111111111111119        6
81111161111111111111111119        6
811111u1111111111111111119       0 0
81111111111111111111111119
81111111111111111111111119
811111111111$1111111111119
81111111111111111111100009
8111111111111111116111c119
81111111111111111161111119
81111111111111111161111119
81111111111111p00000000009
81111111111111611111111119
81111111111111u11111111119
81111111111111111111111119
81111116111111111111111119
8111111611111111111111cc19
811kc11611111111111111cc19
81111116111111111111111119
eooooooooooooooooooooooooa
;