     80000000000009
     81111111111119
     81111111111119
     81111111111119
     81111111111119
     81111111111119
     81111111111119
     81111111111119
     81111111111119
80000000000450000000000009
81111101111111111111111119
81111101111111111111111119
81111101111111111111111119
81111101111111111111111119
81111100011111111111111119
800 0001111111111111111119
81111101111111111111111119
81111101111111111111111119
81111111111111111111111119
81111111111111111111111119
81111111111111111111111119
81111111111111111111111119
81111111111111111111111119
81111111111111111111111119
81111111111111000000000009
81111111111111111111111119
81111111111111111111111119
81111110111111111111111119
81111110111111111111111119
81111110111111111111111119
81111110111111111111111119
8oooooooooooooooooooooooo9
;